111111111
1P0000001
1C0000001
100000001
1000000E1
1000000C1
111111111
