11111111111
1P000000001
10111111101
1C000E000C1
10111111101
10000000001
11111111111
