1111111111111
1P00000000001
1011111111101
1C000000000E1
1011111111101
1C00000000001
1111111111111
