111111111111
1P00000000C1
100111001001
1C00000000E1
100111001001
1C00000000C1
111111111111
